
https://developers.kakao.com/docs/latest/ko/local/dev-guide#search-by-keyword
- 키워드로 장소 검색하기

https://developers.kakao.com/docs/latest/ko/local/dev-guide#search-by-keyword-request-query-category-group-code
CategoryGroupCode
이름	설명
MT1	대형마트
CS2	편의점
PS3	어린이집, 유치원
SC4	학교
AC5	학원
PK6	주차장
OL7	주유소, 충전소
SW8	지하철역
BK9	은행
CT1	문화시설
AG2	중개업소
PO3	공공기관
AT4	관광명소
AD5	숙박
FD6	음식점
CE7	카페
HP8	병원
PM9	약국